R 720 480
NO ./textures/colorstone.png
SO ./textures/purplestone.png
WE ./textures/redbrick.png
EA ./textures/greystone.png

S ./textures/pillar.png
F 220,100,0
C 255,30,0

11111111111111111111111111111
10000000000000000020000000111
10000000000000000000000000011
10000000000000000000000000001
10000000000002000000000000001
10000000000000000000000000001
10000000000002000000000000201
1000000000000N000000000000001
10000000000000000000000000001
10000000000000000000000000001
10020000000002000000000002001
10000000000000000000000000001
10000000000000000000101000001
10000000000000000000101000001
11111111111111111111111111111
